111111111111111111111
1111C11C1111C11P1C111
100000C00M000C0C00001
1000CEC000000000CCCC1
111111111111111111111