1111111111111
1M0P000C0ME01
1111111111111