1111111111111111111111111
1M1111111111111000CM00001
10000000C0000000C11111101
101111111111000M000000001
1000000000000111111111111
1011111111100011111111111
1011111111100111111111111
1011111111101111111111111
1000E0PC000000000000M0001
1111111111111111111111111