11111111111111
1000P000000C11
10000111C10011
1P0011E0000011
11111111111111