111111111
1P0C1C1o1
1C11E1C01
111111111